################################
#..............................#
#..............................#
#..............................#
#..............................#
#..............................#
#..............................#
#..............................#
#..............................#
#..............................#
#..............................#
#.......______.................#
#.......______.................#
#..............................#
#..............................#
#..............................#
#..............................#
x..............................x
x..............................x
#..............................#
#..............................#
#..............................#
#..............................#
#..............................#
#..............................#
#..............................#
#..............................#
#..............................#
#..............................#
#..............................#
#..............................#
##############xx################
